┌─────────────────────────┬─────────────────────────┬─────────────────────────┬─────────────────────────┐
│                         │                         │                         │                         │
│                         │                         │                         │                         │
│                         │                         │                         │                         │
│                         │                         │                         │                         │
│                         │                         │                         │                         │
│                         │                         │                         │                         │
└─────────────────────────┴─────────────────────────┴─────────────────────────┴─────────────────────────┘