┌──────────────────────────┬──────────────────────────┬──────────────────────────┬──────────────────────────┐
│                          │                          │                          │                          │
│                          │                          │                          │                          │
│                          │                          │                          │                          │
│                          │                          │                          │                          │
│                          │                          │                          │                          │
│                          │                          │                          │                          │
└──────────────────────────┴──────────────────────────┴──────────────────────────┴──────────────────────────┘