┌────────────────────────┬────────────────────────┬────────────────────────┬────────────────────────┐
│                        │                        │                        │                        │
│                        │                        │                        │                        │
│                        │                        │                        │                        │
│                        │                        │                        │                        │
│                        │                        │                        │                        │
│                        │                        │                        │                        │
└────────────────────────┴────────────────────────┴────────────────────────┴────────────────────────┘